cou|A Corte se regeu 
abr|Abridger 
adp|Adaptador 
pma|Agência de licenciamento 
anl|Analista 
hst|Anfitrião 
anm|Animador 
ann|Anotador 
ant|Antecedentes bibliográficos 
sht|Apoio ao anfitrião 
ape|Appellee 
pre|Apresentador 
osp|Apresentador na tela 
arc|Arquiteto 
lsa|Arquiteto paisagista 
arr|Arranjador 
art|Artista 
ths|Assessor de tese 
sgn|Assinante 
act|Ator 
vac|Ator de voz 
ato|Autografista 
aut|Autor 
drm|Autor 
ptf|Autor 
aui|Autor da introdução, etc. 
aud|Autor de diálogo 
aft|Autor de pós-palavra, cólofon, etc. 
dub|Autor duvidoso 
aqt|Autor em citações ou resumos de texto 
cll|Calígrafo 
sng|Cantor 
ctg|Cartógrafo 
sce|Cenarista 
std|Cenógrafo 
cns|Censor 
asg|Cessionário 
rth|Chefe da equipe de pesquisa 
led|Chumbo 
fmk|Cineasta 
cng|Cinematógrafo 
cli|Cliente 
col|Coletor 
clt|Collotyper 
clr|Colorista 
cmm|Comentador 
cwt|Comentador de texto escrito 
com|Compilador 
cmp|Compositor 
cmt|Compositor 
ccp|Conceitora 
stg|Configuração 
con|Conservador 
csl|Consultor 
sad|Consultor científico 
csp|Consultor de um projeto 
stl|Contador de histórias 
prc|Contato do processo 
mdc|Contato Metadados 
coe|Contestant-appellee 
cos|Contestante 
cot|Contestante-apelente 
cts|Contestee 
cte|Contestee-appellee 
ctb|Contribuinte 
dtc|Contribuinte de dados 
acp|Copiador de arte 
mcp|Copiador de música 
chr|Coreógrafo 
crp|Correspondente 
crr|Corretor 
crr|Corretor 
len|Credor 
cre|Criador 
cur|Curadoria 
dnc|Dançarino 
enj|Decretando jurisdição 
dto|Dedicador 
dte|Dedicar 
dfe|Defendant-appellee 
dft|Defensor-apelente 
dln|Delineador 
dfd|Demandado 
dpt|Depositário 
dpc|Desenhado 
bjd|Desenhista de colete de livro 
bkd|Desenhista de livros 
bpd|Desenhista de placas de livro 
dsr|Designer 
cov|Designer da capa 
bdd|Designer de encadernação 
cst|Designer de figurino 
sds|Designer de som 
tyd|Designer de tipo 
rcp|Destinatário 
cph|Detentor dos direitos autorais 
drt|Diretor 
ard|Diretor artístico 
adi|Diretor de arte 
fld|Diretor de campo 
fmd|Diretor de cinema 
sgd|Diretor de palco 
pbd|Diretor de publicação 
rdd|Diretor de rádio 
tld|Diretor de Televisão 
ldr|Diretor do laboratório 
pdr|Diretor do projeto 
msd|Diretor musical 
tcd|Diretor técnico 
dis|Dissertante 
dst|Distribuidor 
fds|Distribuidor de filmes 
dnr|Doador 
edt|Editor 
edc|Editor de compilação 
flm|Editor de filmes 
mrk|Editor de marcas 
edm|Editor de trabalho de imagem em movimento 
pbl|Editora 
elg|Eletricista 
elt|Eletropetroleiro 
brd|Emissora 
ctr|Empreiteiro 
prn|Empresa de produção 
eng|Engenheiro 
rce|Engenheiro de gravação 
egr|Engraver 
ive|Entrevistado 
ivr|Entrevistador 
scr|Escriba 
blw|Escritor de Blurb 
wac|Escritor de comentário adicional 
wst|Escritor de conteúdo textual suplementar 
win|Escritor de introdução 
wal|Escritor de letras adicionadas 
wat|Escritor de texto adicionado 
wam|Escritor do material de acompanhamento 
wpr|Escritor do prefácio 
scl|Escultor 
exp|Especialista 
gis|Especialista em informações geográficas 
str|Estereótipo 
etr|Etcher 
prf|Executante 
fmo|Ex-proprietário 
mfr|Fabricante 
ppm|Fabricante de papel 
fac|Facsimilista 
bnd|Fichário 
frg|Forjador 
prv|Fornecedor 
pht|Fotógrafo 
fnd|Fundador 
dtm|Gerente de dados 
stm|Gerente de palco 
pmn|Gerente de produção 
brl|Gofrador em braile 
wde|Gravador de madeira 
hnr|Honorário 
ilu|Iluminador 
ill|Ilustrador 
prt|Impressora 
prm|Impressora 
pop|Impressora de placas 
ins|Inscriber 
ins|Inscriber 
his|Instituição anfitriã 
dgg|Instituição que concede o diploma 
itr|Instrumentalista 
inv|Inventor 
jud|Juiz 
jug|Jurisdição governada 
lbr|Laboratório 
auc|Leiloeiro 
wdc|Lenhador 
lil|Libelant 
lit|Libelant-appellant 
lie|Libelant-appellee 
lel|Libelee 
let|Libelee-appellant 
lee|Libelee-appellee 
lbt|Librettist 
lse|Licenciado 
lso|Licenciador 
lyr|Lírico 
ltg|Litógrafa 
bsl|Livraria 
dbp|Local de distribuição 
pad|Local de endereço 
mfp|Local de fabricação 
prp|Local de produção 
pup|Local de publicação 
evp|Local do evento 
uvp|Lugar universitário 
cnd|Maestro 
mrb|Marbler 
ppt|Marionetista 
med|Médio 
rtm|Membro da equipe de pesquisa 
dgc|Membro do comitê de graduação 
mte|Metal-engraver 
mtk|Minutos 
mod|Moderador 
mon|Monitor 
mus|Músico 
nrt|Narrador 
asn|Nome associado 
att|Nome atribuído 
opn|Oponente 
spk|Orador 
stn|Organismo de normalização 
isb|Organismo emissor 
orm|Organizador 
org|Originador 
oth|Outros 
pan|Painelista 
rpy|Parte responsável 
spn|Patrocinador 
pat|Patrono 
res|Pesquisador 
prd|Pessoal de produção 
pte|Plaintiff-appellee 
pra|Praeses 
fpy|Primeira parte 
pro|Produtor 
plt|Produtor de chapas 
fmp|Produtor de filmes 
bkp|Produtor de livros 
rpc|Produtor de rádio 
tlp|Produtor de televisão 
tch|Professor 
prg|Programador 
prs|Projetista de produção 
lgd|Projetor de iluminação 
own|Proprietário 
cpl|Reclamante 
cpt|Reclamante-apelente 
cpe|Reclamante-apellee 
rcd|Recordista 
apl|Recorrente 
ptt|Recorrente da petição 
ctt|Recorrente do concurso 
red|Redaktor 
cor|Registro de coleta 
ren|Renderizador 
rpt|Repórter 
crt|Repórter do tribunal 
rps|Repositório 
app|Requerente 
pta|Requerente da patente 
cpc|Requerente dos direitos autorais 
rse|Respondent-appellee 
rsp|Respondente 
rst|Respondente-atacante 
rsg|Restager 
rsr|Restaurador 
pfr|Revisor 
rev|Revisor 
cas|Rodízio 
aus|Roteirista 
rbr|Rubricador 
sec|Secretário 
spy|Segunda festa 
dgs|Supervisor de graduação 
wit|Testemunha 
tyg|Tipógrafo 
pth|Titular da patente 
srv|Topógrafa 
trl|Tradutora 
trc|Transcriber 
sll|Vendedor 
vdg|Videógrafo 